Agency - Агентство
The Anaconda - Анаконда
Harpers - Арфисты
Underdark Anarchist's Fellowship - Братство Анархистов Подземья
Bregan D'aerthe - Бреган Д'Эрт
Maces of Elversulth - Булавы Элверсулта
Bushido - Бусидо
The Cowled Wisards - Волшебники в рясах
The She-Wolves - Волчицы
The Jaguar Guard - Гвардия Ягуара
Blood of Morueme – Род Моруим (клан драконов, некогда скрещенных со своими слугами хобгоблинами)
the Veterans' Guild of Ravens Bluff - Гильдия ветеранов Вороньего Утёса
The Xanathar's Guild - Гильдия Ксанатара
the Mercenarie's Guild of Westgate - Гильдия наёмников из Западных Врат
Guild of Underdark Guides - Гильдия Проводников Подземья
Neverwinter Nine - Девятка Невервинтера
Jaezred Chaulssin - Джазред Чолссин
Long Death - Долгая Смерть
The Druids of Tall Trees - Друиды Высоких Древ
The Wraith of the Inner Sea - Привидение Внутреннего Моря
The Iron Legion - Железный Легион
The Iron Throne - Железный Трон
the Yellow Rose - Жёлтая Роза
The Zhentarim - Зентарим
Cleric of Kossuth - Жрецы Коссута
The Golden Legion - Золотой Легион
The Teeth – Зубы
Emerald Cabal – Изумрудное Общество
Emerald Brotherhood - Изумрудное Братство
Emerald Enclave - Изумрудный Анклав
The Twisted Rune - Искривлённая Руна
Clan Hammerhand - Клан Молоторукого
Clan Obarskyr - Клан Обарскир
Fangshields - Клыкощиты
The Claw - Коготь
Code Helm - Кодекс Хельма
The Company of the Wolf - Братство Волка
The Company of Gunnar - Рота Ганнара
Zahar's Krakens - Кракены Захары
The Red Wizards of Thay - Красные Волшебники Тэя
Red Plumes of Hillsfar - Красные Перья Широкохолмья
The Red Ravens - Красные Вороны
The Red Thunder - Красный Гром
The Bloodaxe - Кровавый Топор
Hin's Fist - Кулак Хин
Cult of Dragon - Культ Дракона
Cults of the Moon - Культы Луны
The Lords of Waterdeep - Лорды Уотердипа
People of the Black Blood - Народ Чёрной Крови
The Mages of Halruaa - Маги Халруаа
Malaugryms - Малогримы
The Masquerade - Маскарад
The Mindulgulph - Миндалгальф
The Sailors of the Crimson Sea - Моряки Багрового Моря
The Moonlight Men - Люди Лунного Света
The Soft Claws - Мягкие Когти
The Windriders - Наездники Ветра
The Skykillers - Небесные Убийцы
The Night Masks - Ночные Маски
Affiliated Merchants of the Underdark - Объединение Торговцев Подземья
Fire Knives - Огненные Ножи
The Order of the Silver Lance - Орден Серебряного Копья
The Order of the Blue Boar - Орден Синего Вепря
The Shard - Осколок
Midnight Men - Полуночные люди
The Singing Dawn - Поющий Рассвет
The Enforcers - Громилы
The Purple Flame - Пурпурное Пламя
The Flaming Fist - Пылающий Кулак
The Destroyers - Разрушители
The Renegades - Отступники
The Gauntlet - Перчатка
The Knights of the Unicorn - Рыцари Единорога
Knights in Silver - Рыцари в Серебре
Knights of Imphars II - Рыцари Имфраса II
Knights of the Flying Hunt - Рыцари Летучей Охоты
The Knights of Myth Drannor - Рыцари Миф Драннора
Knights of the North - Рыцари Севера
The Knights of the Shield - Рыцари Щита
The Seven Sisters - Семь Сестёр
The Gray Doom - Серый Рок
Sisterhood of the Oak - Сестринство Дуба
The Blue Sigil - Синий Знак
The Sirocco - Сирокко
The Glowing Hand - Сияющая Рука
The Shining Steel - Сияющая Сталь
Broken Ones - Сломленные
Servant of the Royal Egg - Слуги Королевского Яйца
The Society of the Sword - Совет Меча
Order of the Sun Soul(Brotherhood of the Sun) - Орден Солнечной Души (Братство Солнца)
The Union of Lords - Союз Лордов
Llandrydd's Steel - Сталь Лландридда
Raven Claw - Вороний Коготь, отряд
Old Order, Elder Order - Древний Орден
Guardians of the Weave - Стражи Плетения
The Dark Moon - Тёмная Луна
The Dark Watch – Тёмный Дозор
The Shadow Thieves - Теневые Воры
Shades - Тени
The Silent Rain - Тихий Дождь
Fellowship of the Purple Staff - Братство Пурпурного Посоха
The Seven Suns Trading Coster - Торговая Организация Семи Солнц
The Chill - Холод
The Blacktalons - Чёрные Когти
The Shieldbreakers - Щитоломы
Eldreth Veluuthra - Элдрет Велуутра
Council of Elders - Совет Старших (Халруаа)
House Jordain - дом Джордайн
Maquar - макуары
Shadow wizards - Теневые волшебники
Stone Shields – Каменные Щиты
Mirabar’s Shield - Мирабарские Щиты/Щиты Мирабара (элитная гвардия Мирабара)
Shieldsar – Защитники (регулярная армия Сандабара)
Scourged Legion – Карательный Легион (армия Каанира Вока)
Arcane Brotherhood of Luskan - Тайное братство Лускана
Kraken Society - Общество Кракена
Council of the Sparkling Stones - Cовет Искрящихся Камней
Hands of Yartar - Руки Яртара
